111111111111111111111111
120100000001000000000031
110100000001001111111111
100000000001000000000001
111111100001111111111001
100000001101110000000001
100000100001510011111111
100001000001010000000001
111110111100011111011111
150010000001010000000001
111010000001011111111101
100000000001000000000001
111111111111111111111111